1111111111111
100100000C0C1
10000C00C0001
10X0000000001
1000111000001
1000001000001
100000E000001
1001111111001
100000P000001
1000000000001
10010C0C01001
10000000000X1
1111111111111