1111111111111
100100000C0C1
10000C00C0001
1000000000001
1000111000001
1000001000001
100000E000001
1001111111001
1000000000001
1000000000001
1000000C00001
100P000000001
1111111111111