111111111111111111111111111111111111111111111111111111111111111
100000000000000000000000000000000000000000000000000000000000001
101111111011111111111111111111111110101010101011101010101011111
101111111011110000000000000000000000000111111111000000000000001
1000000000000C00000000C0000000000C000000000C0000000000000000001
100011111111100000000000000000000000000000000000000000000000001
101010101010101010101010101010101010101010101010101010101010101
100000000000000000000000000E11111111111111111100000000000000001
1000000000000000000011111111100C0000000000000000000000000000001
100000000000000000001111111110000000000011111111100000000000001
101010101010101010101010101010101010101010101010101010101010101
100000000000000000000000000000000000000000000000000000000000001
101010101010101010101010101010101010101010101010101010101010101
101010101010101010101010101010111010101010101011101010101010101
100000000000000000000000000000000000000000000000000000000000001
100000000000P00000000111111111111111111000000000000000000000001
10000000000000000000000000000000011111111100000000000000000E001
111111111111111111111111111111111111111111111111111111111111111