111111111111111111111111111111111111111111111
1CC0CCCP00C0000000000000000000000000000000001
1C0C0E101010111000000000000000000000000000001
1CC0000000E0000000000000000000000000000000001
100C00110000111111100000000000000000000000001
1EEEEEEE0000000000000000000000000000000000001
101010101010101010000000000000000000000000001
100000000000000000000000000000000000000000001
100000000000000000000000000000000000000000001
100000000000000000000000000000000000000000001
101010101010101010101010101010101010101010101
100000000000000000000000000000000000000000001
100000000000000000000000000000000000000000001
100000000000000000000000000000000000000000001
101010101010101010101010101010101010101010101
100000000000000000000000000000000000000000001
100000000000000000000000000000000000000000001
100000000000000000000000000000000000000000001
101010101010101010101010101010101010101010101
100000000000000000000000000000100000000000001
100000000000000000000000000000100000000000001
100000000000000000000000000000100000000000001
101010101010101010101010101010101010101010101
100000000000000000000000000000000000000000001
100000000000000000000000000000000000000000001
100000000000000000000000000000000000000000001
101010101010101010101010101010101010101010101
100000000000000000000000000000100000000000001
100000000000000000000000000000100000000000001
100000000000000000000000000000000000000000001
101010101010101010101010101010101010101010101
100000000000000000000000000000000000000000001
100000000000000000000000000000000000000000001
100000000000000000000000000000000000000000001
101010101010101010101010101010101010101010101
100000000000000000000000000000000000000000001
100000000000000000000000000000000000000000001
100000000000000000000000000000000000000000001
101010101010101010101010101010101010101010101
100000000000000000000000000000000000000000001
100000000000000000000000000000000000000000001
100000000000000000000000000000000000000000001
101010101010101010101010101010111010101010101
100000000000000000000000000000000000000000001
111111111111111111111111111111111111111111111